|                 |
|  y         r    |
|                 |
|                 |
|###########      |
|                 |
|                 |
|  g         b    |
|                 |
